1111111111111
1ECP0N1111111
1111111111111